// Initial position, dirty probability, random seed, map
5 5 0.01 1
O O O O O O O O O O
O - - - - O - - - O
O O O O - - - O - O
O - - O - O O O - O
O - O O - - - O O O
O - - O - O - O - O
O - - O - O - O - O
O - O O O O - - - O
O - - - - - - O - O
O O O O O O O O O O
